 , ,S,#,#,#,#,#,#,#,#,#,#,#,#,#,#,#,#,#,#,#,#,#,#,#,#,#,#,#,#
 , , , , , , , , , , , ,#, , , , , , , , , , , , , , , , , ,#
#, , ,#,#,#,#,#,#,#, , ,#,#,#,#,#,#,#,#,#,#, , ,#,#,#,#, , ,#
#, , , , , ,#, , ,#, , ,#, , , , , ,#, , , , , ,#, , , , , ,#
#,#,#,#,#,#,#, , ,#, , ,#, , ,#,#,#,#, , ,#, , ,#,#,#,#,#,#,#
#, , , , , , , , , , , ,#, , ,#, , , , , ,#, , , , , , , , ,#
#, , ,#,#,#,#, , ,#, , ,#, , ,#,#,#,#,#,#,#, , ,#, , ,#,#,#,#
#, , , , , ,#, , ,#, , ,#, , , , , , , , ,#, , ,#, , , , , ,#
#, , ,#,#,#,#,#,#,#, , ,#, , ,#,#,#,#,#,#,#, , ,#,#,#,#, , ,#
#, , , , , ,#, , , , , ,#, , ,#, , ,#, , ,#, , ,#, , ,#, , ,#
#, , ,#, , ,#, , ,#, , ,#, , ,#, , ,#, , ,#, , ,#, , ,#, , ,#
#, , ,#, , ,#, , ,#, , ,#, , , , , ,#, , ,#, , ,#, , , , , ,#
#, , ,#,#,#,#,#,#,#, , ,#, , ,#,#,#,#, , ,#,#,#,#,#,#,#, , ,#
#, , ,#, , ,#, , , , , , , , , , , , , , , , , ,#, , , , , ,#
#,#,#,#, , ,#, , ,#,#,#,#, , ,#,#,#,#, , ,#,#,#,#,#,#,#, , ,#
#, , , , , , , , , , , ,#, , ,#, , , , , , , , , , , , , , ,#
#,#,#,#,#,#,#,#,#,#,#,#,#, , ,#,#,#,#,#,#,#, , ,#,#,#,#, , ,#
#, , , , , ,#, , ,#, , , , , ,#, , ,#, , ,#, , ,#, , , , , ,#
#, , ,#,#,#,#, , ,#, , ,#, , ,#, , ,#, , ,#,#,#,#, , ,#,#,#,#
#, , , , , , , , , , , ,#, , , , , , , , ,#, , , , , , , , ,#
#,#,#,#,#,#,#,#,#,#,#,#,#,#,#,#,#,#,#,#,#,#,#,#,#,#,#,#, ,E,#