#,S,#,#,#,#,#,#,#,#
#, , , , , , ,#, ,#
#, ,#,#, ,#, ,#, ,#
#, , ,#, ,#, , , ,#
#, ,#,#, ,#,#,#, ,#
#, ,#, , ,#, , , ,#
#,#,#,#, ,#, ,#, ,#
#, , ,#, ,#, ,#, ,#
#, ,#,#,#,#,#,#, ,#
#, , , , , , , , ,#
#,#,#,#,#,#,#,#,E,#